Afraid	NNP
Berserkers	NNS
Bleeding	VBG
Crucifix	NNP
Curse	NNP
Dracula	NNP
Draculas	NNP
Fears	NNS
Vampire	NNP
Un-Dead	JJ	NNP	NN
Un-Deads	NNS
Unclean	JJ	NN
Wolves	NNS
_nosferatu_	JJ	NNP
abasement	NN
abnormal	JJ
abnormally	RB
ashy	JJ
barking	NN	VBG
bats	NNS
berserker	NN
bite	NN
biting	VBG
bitten	VBN
bled	VBN	VBD
bleed	VB	NN
bleeding	VBG	JJ
blood	NN
blood-curdling	JJ
blood-dripping	JJ
blood-stained	JJ
bloodless	JJ
bloodstained	VBN
bloody	JJ	NN
butchery	NN
carnal	NN	JJ
carrion	NN
child-brain	NN	JJ
child-mind	NN
choking	VBG	NN
claw	NN
coffin	NN
coffin-box	NN	JJ
coffin-home	JJ
coffin-lid	JJ
coffin-man	NN
coffined	VBN
coffins	NNS
cold-bloodedness	NN
compel	VB
compelled	VBN
corpse	NN
corrupt	JJ
corruption	NN
cowering	NN
crave	VBP
craving	NN
creep	VB
creeping	NN	VBG
cross-bones	NNS
crucifix	NN
crucifixes	NNS
cruel	JJ	NN	VBN
cruelly	RB
cruelty	NN
cursed	VBN	JJ	VBD
damned	JJ
dead	JJ	VBP	NN
death-chamber	NN
death-trap	NN
debased	VBN
demon	NN
demoniac	JJ
demons	NNS
devil	VBZ	NN	JJ
devil-begotten	JJ
devilish	JJ
devils	NNS
dread	NN	VBP	VB	JJ	VBZ
flesh	NN	JJ	VBP
fright	NN
frighten	VB	VBP	JJ
frightened	VBD	VBN	JJ
ghastly	RB	JJ
ghost	NN
ghostly	JJ	RB
ghosts	NNS
gloom	NN
grave	NN	JJ	VBN	VB	VBP
gravediggers	NNS
grisly	JJ	RB
growl	NN
growling	VBG
growls	NN
gruesome	JJ
gurgling	NN	VBG
handspike	NN
hell-fire	NN
hell-home	JJ
hellish	JJ
hideous	JJ
horrified	VBN	JJ
horrify	VB
horror	NN
horrors	NNS
horrorstruck	JJ
jackals	NNS
jugular	NN
life-blood	JJ
life-eating	JJ
monster	NN
monsters	NNS
monstrous	JJ
murder	NN	VB
murdering	VBG
murders	NNS
mutilate	VB
mutilating	VBG
mutilation	NN
necromancy	NN
night-existence	NN
nightmare	NN	JJ
overwhelm	VB
overwhelmed	VBN	VBD
overwhelming	JJ
pagan	JJ
pale	NN	JJ	VBZ
paleness	NN
paler	JJR	NN
pall	NN
pallid	JJ
pallor	NN
phantoms	NNS
post-mortem	JJ	NN
powers	NNS
prick	NN
raving	VBG
ravings	NNS
recoil	NN
recoiled	VBD
red	JJ	NN	VBD
redden	VB
reddened	VBN
reddening	VBG
redder	JJR	NN
reddish	JJ
reeked	VBD
reeking	VBG
repulsive	JJ
sanguine	NN
savage	NN
savagely	RB
scream	NN	VB
screamed	VBD	VBN
screaming	VBG
screams	NNS
screech	NN
screeching	NN
semi-demons	NNS
skeleton	NN
snarl	NN
snarled	VBD
stagnant	NN
suck	VB	VBP	VBD
sucked	VBN
teeth	NNS	NN	JJ
terrified	VBN
terror	NN
terrors	NNS
torn	VBN	JJ
torn-open	JJ
torture	NN	VB
tortured	JJ
torturing	VBG
uncanny	JJ
unclean	JJ
unhallowed	JJ
unholy	JJ
unhuman	JJ
unnatural	JJ
unspeakable	JJ
unutterable	JJ
unutterably	RB
vampire	NN
vampires	NNS
vein	NN
veins	NNS
venalia	NN
vile	JJ	NN
vilely	RB
wicked	JJ
wickedly	RB
wickedness	NN
wolf	NN	VBP	VB
wolfs	NN
wolves	NNS	VBZ
